1111111111111
10010000000C1
1000011111001
DP0011E00000D
1111111111111