1111111111111
10010000000E1
1000011111001
1P00110000001
1111111111111