1111111111111
10010000000E1
1000011111001
1P001100000C1
1111111111110