111111111111111111
1C010000000C0000C1
100001111100M00001
1P0011E00C0000C001
100C010000000M0001
111111111111111111
