1111111111111111
10010000000C0001
100001111100M001
1P0011E00C0000C1
1111111111111111