1111111111111111111111111111111111
1E00000000M0000C00000C0M00000000M1
1010010100100000101001000000010101
1010010010101010001001000000010101
1P0000M00C00C000000000M0000000M0C1
1000000000000000000000000000000001
1111111111111111111111111111111111