11111111111111111111111111111
1E00000000000C00000C000000001
10100101000000101001000010101
10100100101010001001000010101
1P00000C00C000000000M000000C1
10000C000000M00000000000C0001
11111111111111111111111111111
